Choque=Collision
Autolesiones=Selfharm
Choque contra objeto fijo=Collision against fixed object
Volcamiento=Rollover
Choque con volcamiento=Collision with rollover
Automóvil=Automobile
Motocicleta=Motorcycle
Taxi=Cab
Bus=Buses
Camión=Truck
Bicicleta=Bicycle
Camioneta=Van
Peatón=Pedestrian
Tracto camión=Tractor Truck
Vehiculo de servicio especial=Special service vehicle
Volqueta=Dump truck
Bicitaxi=Rickshaw
Ambulancia=Ambulance
Grúa=Crane
Micro bus=Minibus
Bus articulado=Articulated bus
Carreta=Cart
Animal de compañia=Animal companion
Vehiculo de valor=Stock vehicle
Patineta=Skateboards
Otro=Other
Pasajero=Passenger
Semoviente - animal silvestre=Livestock
Vivienda=Living place
Casa=House
Heridos=Injuries